1111111111111111111111
10000000001010E0000011
1000000000000000000111
10P00000C000C000000011
100000000010C000000001
100000C0001000000000E1
1000000001100110000001
1111111111111111111111
