1111111111
1000000001
10000P0001
1111111111
