11111111
10000001
1000000
11111111
