11111111111111
10E0CP0000E001
111000010000C1
10001000001001
10001110000001
11111000000001
11111111111111
