11111111111111
10E0C00000E001
11P000010000C1
11111111111111
