1111111111
10C0000P01
1E00000P01
1111111111
