11111111111111
11000000000001
11P00000000001
11111111111111
