11111111111111
11E0C000000001
11P00000000001
11111111111111
